а: А
абзац: абзац
автоматически: автоматически
адрес: адреса
активно: активно
алиса: Алисы
альтернатива: альтернатива
альтернативный: альтернативные
амперсанд: амперсанды
анализировать: анализирует
аналогия: аналогии
английский: английском
англоязычный: англоязычная
аргумент: аргументов, аргумент, Аргумент, аргументами, аргументы, аргумента, аргументом
архив: архив, архива
архивный: Архивная
атрибут: атрибуту, атрибуты, Атрибут, Атрибуты, атрибутов, атрибутам, атрибута, атрибутами, атрибут
база: базу
байтовый: байтовую, байтовой
бардак: бардак
без: Без
безумно: безумно
бесполезный: бесполезной
библиотека: библиотеку, библиотека, библиотеки, Библиотека
благодаря: благодаря
блок: блоком
больший: Большая, больший, большие
большинство: большинство, большинстве
большой: большой, Больше
брать: берет
браузер: браузер
буква: буквы, букву
быстродействие: быстродействия
быстрый: быстрый, быстрым, Быстрый, быстрее
быть: Было, Были, Будьте
в: Во, В
важно: важно
важный: важными, важнее
валидный: валидным, валидный
вариант: варианты, вариантов, вариант
ваш: вашей, вашу, ваших, вашего, вашим, вашем, вашему
вбок: вбок
веб: веб
вернуть: вернуть, вернет, вернул
вернуться: Вернемся
верный: верна
вероятно: вероятно
вероятность: вероятность
версия: версиях, версии, версиями, версия, версий, версией, версию
верх: верха
верхний: верхний, верхнего
ветка: ветку, веткой
вещь: вещи
взаимодействие: взаимодействия
взгляд: взгляд
взглянуть: взглянуть, Взгляните
взять: Возьмем
вид: видами, виду, вида, Виды, виде
видеть: видите, видели
вика: вики
виртуальный: виртуальной
висячий: висячий
включать: включает
включая: включая
включить: включенный
вкратце: вкратце
вложить: вложенной
вместе: вместе
вместо: вместо, Вместо
вне: вне
внешний: Внешняя, внешние
внимание: внимание
внутри: внутри
возвращать: возвращает, возвращаемое
возвращаться: Возвращаясь
возможно: Возможно, возможно
возможность: возможности
возможный: возможных
возникнуть: возникли
волноваться: волноваться
волшебство: волшебство
вообще: вообще
вопрос: вопросы
вот: Вот
вперёд: вперед
вроде: вроде
вручную: вручную
вряд: Вряд
вставлять: вставляет
встретить: встречен
встретиться: встретилось
встречаться: встречается, встречаются
встроить: встроенного, встроенным, встроенный
всё: Все
второй: Второй, втором, вторых, второго
вход: входе
входить: Входит
входящий: Входящие, входящего
вы: Вы, Вам
выбирать: выбирает
выбор: выбору
выбрать: выберет, выбранной, выбрать
вывести: вывести, выведет
вывод: вывод, выводом, вывода, выводе, Вывод
выводиться: выводятся, выводится
выглядеть: выглядят, выглядит, выглядеть
выдавать: выдавали, выдает
выдать: выдаст
вызвать: вызовете, вызовет, вызвать, вызовите, вызвано, вызвали
вызов: вызова, Вызов, вызов
вызывать: вызывает, вызывать, вызываете
вызываться: вызывается
выключить: выключить
выполнить: выполнит, выполнен
выполнять: выполнять
выражение: выражению, выражением, выражение
вытащить: вытащил
выход: выходе
выше: выше
выяснить: выяснить
где: Где
генератор: генератора, генераторам, генераторы, Генераторы, генератор
генерировать: генерировал, генерировать
генерироваться: генерируются
глубоко: глубоко
говориться: говорилось
готовый: готовы
группа: группу
давать: даете, давать, дают, дает, Давайте, давайте
далее: далее
данные: данных, данным
данный: данный, данного
дата: Дата
дать: данному, дадут, дал, дать, данные, дадите, даст
два: двум
действительный: действительному
декабрь: декабря
декодирование: Декодирование, декодирование
декодировать: декодировать
делать: делать, делает, делают
делаться: делается
дело: дело, деле, делом
день: дни
дерево: дереве, дерево, деревья, деревом, дерева, дереву
дескриптор: дескриптор
десятка: десяток
дискуссионный: дискуссионную
дистрибутив: дистрибутивами
для: Для
добавить: добавьте, добавить, добавив
добавиться: добавится, Добавились
добавлять: добавлять, добавляет, добавляют, добавляете
добавляться: добавляется
догадка: Догадки, догадка
документ: документах, документ, документов, документом, документы, документе, Документ, документу, документа
документация: документации, документацию, документация, Документация
должный: должен, должна, должны
дополнительный: дополнительных
допустить: Допустим
доступ: доступ
доступный: доступен, доступна, доступное, доступных, доступны
дочерний: дочернего, дочерними, дочерние, Дочерние, дочерним, дочерних, дочерний
друг: друг, друга, другом
другой: другого, Другие, другую, другими, Другая
единственный: единственного, единственное, Единственный, Единственное, единственной, Единственная, единственный, единственным, единственные
единый: единую, единое
если: Если
естественный: естественные
есть: Есть
забыть: забудьте, забыть
завершение: завершения
зависимость: зависимости, зависимость
заголовок: заголовка
загрузить: загрузите
задать: заданному, заданным
задача: задача, задач
задержка: задержек
заключаться: заключается
закончить: закончите
закопать: закопанного, закопанной
закрывать: закрывающий, закрывающую
закрыть: закрыть
замена: замена, заменой, замены
заменить: заменен, заменены, замените, заменено, заменить
заменять: заменяет
заметить: заметить
занимать: занимает, занимать
занять: занять
записать: записать
запись: запись
запрос: запрос
запуск: запуском, запуска
запускать: запускает, запускать
запустить: запустить, запустили
запятая: запятая, запятой
зарезервированный: зарезервированным, зарезервированных
заставить: заставить
затем: Затем
здесь: Здесь
здорово: здорово
знак: знаком, знака
знакомый: знакомо
знать: знаете, зная, знает, знать
значение: Значение, значением, значения, значение, значений, значению, значениями, значении
значительно: значительно
и: И
игнорировать: игнорировал, игнорирует, игнорировать
игнорироваться: игнорируется, игнорируются, игнорироваться
идеально: идеально
идентифицировать: идентифицирует
идея: идею
идти: идут, идет
избежать: избежать
извлекать: извлекает
извлечение: извлечения
извлечь: извлечен, извлечь, извлечена
изменение: изменение, изменения, Изменение, изменений
изменить: изменить, измените
измениться: изменилось
изменять: изменяют, изменять
изначально: изначально
изначательный: изначательно
изучить: изучить
или: Или
иллюстрировать: иллюстрируют
именовать: именованные, именованного, именованный, Именованные, именованными, именованных, именованным
иметь: имейте, имеют, имеет
имя: именем, именами, Имена, имена, имени, имен, Имя
иначе: иначе
иногда: Иногда
инструкция: инструкции
инструмент: инструменты
интересовать: интересующие
интерфейс: интерфейс
информация: информации
искать: искал, искать, ищут, ищете, Ищите
исключение: исключением, исключение
исключительно: исключительно
искомый: искомой, искомом
использование: использованием, использования, использование, Использование
использовать: использовал, Используйте, использован, используют, используемый, использовать, используете, используемые, использованного, используйте, использую, используя, использует, использовали
использоваться: использоваться, используется
исправить: исправить
исправлять: исправляйте
испытать: испытаем
источник: источником, источников
исходный: исходного, исходным, исходном, исходный
к: К
кавычка: кавычки
каждый: каждого, каждом
как: Как
какой: какие, Какой, каком, каким, какого
карась: Карась
каталог: каталоге, каталог
качество: качестве
китайский: китайский
класс: классам, классов, классу, классы, классом, класс, Класс, класса
ключевой: ключевое
когда: Когда
код: код, коды, кодом, коде, кода
кодирование: кодирование
кодировать: кодированную, кодирован
кодироваться: кодироваться, кодируется
кодировка: кодировкой, Кодировки, кодировки, кодировок, Кодировка, кодировку, кодировке
кодовый: кодовую
кой: Кое
количество: количество
команда: команд
комбинация: комбинации
комбинировать: комбинировать
комментарий: комментарий, Комментарии
комплект: комплект
компьютер: компьютере, компьютерах
компьютерный: компьютерное
конверт: конверт
конвертация: конвертации
конвертировать: конвертируют, конвертировать, конвертирует
конвертироваться: конвертируются, конвертируется
конец: конце, конец
конечный: конечного
конкретный: конкретную
консоль: консоль
константа: Константы
конструктор: Конструктор, конструктора, конструктору, конструктор, конструкторе
контролировать: контролирует
контроль: контроль
копирование: Копирование
копия: Копия, копии, копия
короткий: короткий
косой: косую
который: которую, котором, которое
крайний: крайней
красиво: красиво
красивый: красивого, Красивое
критерий: критериям
критично: критично
лакей: Лакей
либо: либо
лицензировать: лицензирован
лицензия: лицензия, лицензии
лишний: лишних
любимый: любимым
любой: любое, любая, Любые, Любой, любых, любому, любого, любым, любой
машина: машинах
медленный: медленный
менять: менять
мера: мере
место: место
метод: метода, методом, методах, методов, Метод, методы, метод
мнемоник: мнемониками, мнемоники, мнемоник, Мнемоники
многие: Многие
многозначный: многозначного, многозначных, Многозначные, многозначным, многозначный
многократно: многократно
множество: множество
модуль: модуль
можно: Можно
момент: момент, моменту
мочь: можете, Может, можем, могло, могли
мы: Мы
мышка: мышки
на: На
навигация: навигации, Навигация
надеяться: Надеюсь
надмножество: надмножество
название: названием
назвать: назвать
называть: называем
называться: называется, назывался
наиболее: Наиболее
найти: найдете, найдет, найденные, найден, найти, найдено, нашел, Найти
найтись: нашелся, нашлась
наличие: наличие
намного: Намного, намного
наоборот: наоборот
написать: написанного, написать, написали, напишите, написан, написанном, написанный
например: Например
напрямую: напрямую
нарушать: нарушают
насколько: насколько
настолько: настолько
настоящий: настоящая
настройка: настройки, настройку, настроек
находить: находит, находят
находиться: находятся, находится
начало: началом, начало, начале
начальный: начального
начать: начать, начал, начав, начали
начинать: Начиная
начинаться: начинаются
наш: нашем
не: Не
невалиден: невалиден
невалидный: невалидный
недостаток: Недостатки, недостатки
недостаточно: недостаточно
независимо: независимо
неидеальный: неидеально
неизвестный: неизвестной
неисправность: неисправностей
некоторый: некоторой, некоторые, некотором, некоторое, некоторых, Некоторые
нельзя: Нельзя
немногое: немногим
необходимо: необходимо
неодинаковый: неодинаковы
неоднозначный: неоднозначной
неоднократный: неоднократного
неожиданный: неожиданное, неожиданным, неожиданного
непосредстввенный: непосредстввенно
непосредственно: непосредственно
непосредственный: непосредственный, непосредственные, непосредственных
неправильно: неправильно
неправильный: неправильной
непрямой: непрямым
нераспознанный: нераспознанный
несколько: нескольких
несогласованный: Несогласованные
несоответствие: несоответствия
нестрогий: Нестрогий, нестрогий
нечувствительный: нечувствительны
неясный: неясным
нижний: нижний
ничто: ничто
но: Но
новый: новая, Новое, новой, новую, новым, новые, новый, нового, новое
номер: номер
нужный: нужна, нужен, Нужен, нужны
нумерация: Нумерация
о: Об
оба: обоих
обнаружить: обнаружить, обнаружите, обнаружил
обновить: обновить
обрабатывать: обрабатывают, обрабатывать
обрабатываться: обрабатываться
обработать: обработать
обработка: обработке, обработка
образ: образом
образец: образца
обратить: Обратите
обратиться: обратитесь
обратно: обратно
обратный: обратную
обращаться: обращаясь
обращение: обращении, обращения
обстоятельство: обстоятельств
общий: общий, общего
объединение: объединения, объединение
объединяться: объединяются
объект: объектами, объектов, объекта, объекты, объект, объектом, объекте, Объект, объекту
объявление: объявление
объяснять: объяснял, объяснять
обычный: обычные, обычную
обязательно: обязательно
обёртка: обертку
обёртывать: обертывает
ограничивать: ограничивает
огромный: огромный
один: Одним, Одна, одно, одну, одна, одном, Один
одинаково: одинаково
одинаковый: одинаковым, одинаковой
однако: Однако
одновременно: одновременно
одноуровневый: одноуровневыми, одноуровневых, одноуровневые
ожидание: ожидания
ожидать: ожидаете
означать: означает
оказаться: оказаться
окружный: окружен
он: Его, Он
она: Она
они: ним, Они
онлайн: онлайн
оно: Оно
опираться: опирается
описать: описанных, описанные
оправдывать: оправдывает
определение: определения
определить: определены, определите, определено, определит, определена, определен
определять: определяет
определяться: определяется
определённый: определенную, определенной, определенному, определенными, определенным, определенное, определенный
опять: Опять
оригинал: оригинала, оригиналу
оригинальный: оригинальной, оригинальный
основа: основе
основать: основанные
основное: основном
основной: основные, основной
основный: основных, Основная, основного, основными
особенность: особенностями
особый: особого, особый
оставаться: остается
оставить: оставит
остальной: остальная, остальных, остальное
останавливаться: останавливаются, останавливались
остаться: осталось, оставшуюся
осторожный: осторожны
от: От
отделить: отделена
отдельный: отдельной, отдельных
отделять: отделяющий
отклик: отклика
отключить: отключить
открывающть: открывающй
открытый: открытый
открыть: открыть
отличаться: отличается
отличие: отличие
отличный: отличный
относительно: относительно
относиться: относиться, относится
отношение: отношение, отношении
отображать: отображать
отображаться: отображается
отобразить: отобразить
отправить: Отправьте, отправьте
отразить: отразить, отражено
отслеживать: отслеживать
отступ: отступом
отсутствовать: отсутствующим, отсутствует
отфильтровать: отфильтрует, отфильтровать
отфильтровывать: отфильтровывает
отформатировать: отформатирован, отформатированную
отчёт: отчет
оформить: оформленный, оформлен
охватывать: охватывают
оценивать: оценивает
оценить: Оцените
очень: Очень
очистить: очистить
очищать: очищать
ошибка: Ошибки, ошибок, ошибке, ошибка, ошибки
ошибочно: ошибочно
ошибочный: ошибочные
пакет: пакета, пакет, Пакет, пакетами
память: памяти
пара: пару, пара
параграф: параграфе
парный: Парные, парные
парсер: парсером, парсерами, парсеров, парсера, парсеры, Парсер, парсер, Парсеры
первоначальный: первоначального
первый: первых, первые, первом, первое, первым, первого, Первым
перебирать: перебирать
перебор: перебора
перебрать: перебрать
перевести: переведена
перевод: Перевод, переводы, Переводы, переводе, перевода, перевод
переводить: переводите, переводить
передавать: передавать, передаете
передаваться: передаваться
передать: Передайте, переданным, передадите, передав, передайте, передать, Передав
передача: передача, передачей, передачи
переименование: переименований
переименовать: переименовать, переименованы, переименовал
перейти: перейти
перекрывать: перекрывающих
переменный: переменные
перемещение: перемещения, Перемещение
перенос: Перенос
переопределить: переопределить
переписать: переписан
переставлять: переставляет
перечисленный: перечисленного, перечисленных
перечислить: перечислены
писать: писали, пишете
планировать: планируете
платить: платите
по: По
побайтовый: побайтового
поведение: поведение, поведения
повлиять: повлиять
повторить: повторить
повторять: повторять
повышение: Повышение
подавать: подаете
подбиблиотека: подбиблиотеку
поддерживать: поддерживают, поддерживаемый, поддерживаемых, поддерживает
поддерживаться: поддерживается, поддерживаются
поддержка: поддержка
подкласс: подкласс, подклассами, Подклассы
подключить: подключить
поднимать: поднимает
подобный: подобных
подобрать: подберет
подробно: подробно
подробность: подробности
подробный: подробной, подробнее
подряд: подряд
подсчитывать: подсчитывает
подумать: подумать
подход: подход
подходить: подходит
подходящий: подходящие
пожалуй: Пожалуй
позволять: позволяя, позволяет
поздний: поздними
позиция: позицию, позиция
поиск: Поиск, поиска, поиске, поиск, поисках
поискать: поискать
поисковый: поисковом
показать: покажу, показать
показаться: показаться
показывать: показывающий
полезно: полезно
полезный: полезной, полезен
полностью: полностью
полный: полной
получать: получаете, получать
получение: получения
получить: получите, получат, получить, получили
польза: пользы
пользователь: пользователями, пользователи
поменять: поменять
поместить: поместив
помнить: Помните
помогать: помогает
помочь: поможет
помощь: помощью
понимание: пониманием
понимать: понимают, понимает
понять: понять
попасть: попала
попробовать: попробовать
популярный: популярных, популярным
попытаться: попытались
попытка: попытки
португальский: португальский
порядок: порядке
поскольку: Поскольку, поскольку
после: После
последний: Последнее, последнюю, последний
посмотреть: посмотреть, посмотрим
поставляться: поставляется
постоянно: постоянно
потеряться: потерялись
потомок: потомков, потомка
похоже: похоже
похожий: похожа, похожи, похожий, похож
почему: Почему
поэтому: поэтому
появиться: появился, появиться, появилось
появляться: появляются, появляется
правило: правила
правильно: правильно
правильный: правильный, правильным, правильную
правомерно: правомерно
практически: практически, Практически
превратить: превращен, превратить, превратит
превращать: превращает, превращать
превращаться: превращаются
предельный: предельное
предлагать: предлагает
предложение: предложения
предложить: предложите, предложили
предназначить: предназначенную, предназначено
предоставлять: предоставляет
предостережение: предостережение
предполагать: предполагает
предположение: предположения
предпочесть: предпочесть
представить: представлен, представлены
представление: представление, представления
представлять: представляют, представляет
предшествовать: предшествуют
предыдущий: предыдущий, предыдущая
прежде: Прежде
преимущество: преимущества, Преимущества
прекратить: прекращена, прекратить
преобразование: преобразования, преобразование
преобразовать: преобразовал, преобразовать, преобразованы, преобразует, преобразован
преобразоваться: преобразовались, преобразуется, преобразуются
преобразовывать: преобразовываете
прервать: прервано
претендовать: претендовать
при: При
привести: привести, привел, приведет
приветствоваться: приветствуются
пригодиться: пригодится
приготовление: Приготовление
прийтись: придется
приличный: Приличная
приложение: приложения, приложением
приложить: приложите
применяться: применяются
пример: Примеры, пример, примеров, примере, примерах, примера, примеры
принимать: принимает, принимают
принудительно: принудительно
присвоить: присвоено
присутствовать: присутствует
приходиться: приходится
причина: причина, причине
проанализировать: проанализирует
пробел: пробелы, пробелов
проблема: проблем, Проблемы, проблемы, проблему, проблема
проверить: проверить, проверит
проверка: Проверка
прогон: Прогон
программа: программы
программист: программистам
программистский: программистского
продолжать: продолжайте
продолжение: продолжение
проект: проекту
проигнорировать: проигнорирует
производительность: производительности
происходить: происходит
пропускать: пропускает, пропускать
прорабатывать: прорабатывают
просматривать: просматривает, просматривать, просматривая
простой: Простой, простейший, простой, простым, простых
пространство: пространство, пространства
противоположность: противоположностью, противоположность
проход: Проход
проходить: проходить
процесс: процессе
прочее: Прочее
прочий: Прочие, прочих
проявляться: проявляется
прямой: прямым, прямой
публиковать: публиковать
публиковаться: публикуется
пугать: пугает
пустой: пустым, пустой, пустых, пустыми
пусть: пусть
путаница: путаницы
путь: пути
путём: путем
пытаться: пытаетесь
пять: Пять
работа: работы
работать: работать, работают, работали, работая, работает
равенство: равенство
равно: равно
равный: равной, равные, равны, равен
разбирать: разбирает, Разбирает, разбирал, разбираете, разбирать
разбор: Разбор, разбором, разбора, разборе
развиваться: развивается
раздел: раздел, раздела, разделах, разделе
различие: Различия, различиях, различие, различия
различный: различных, различные
разметка: разметки, разметка, разметку, разметкой, разметке
разница: Разница, разницу, разница
разный: Разные, разных, разному, разные
разобирать: разобирать
разобрать: разобранный, разобрана, разобрать, разобран, разобрано, разобрали, разобранных
разобраться: разобраться
разработать: разработать
разработка: разработки
разрешить: разрешит, разрешено
ранее: ранее, Ранее
ранний: Раньше, ранних, раннюю
распаковка: распаковке
распознавание: распознавание
распознаваться: распознается
распознать: распознает
распространить: распространенных, распространенная, распространенные, распространенный
распространять: распространять
рассказать: расскажу
рассказывать: рассказывать
рассматривать: рассматривая, рассматривал, рассматривать
рассматриваться: рассматриваются
рассмотреть: рассмотрим, рассмотреть, рассмотрены, Рассмотрим
расход: расход
реализация: реализация
реализовать: реализуют
реальный: реальных
регистр: регистру, регистр
регулярный: регулярным, Регулярное, регулярное, регулярному
редактировать: редактировать
редкий: редких
редко: Редко
резко: резко
результат: результаты, результатов, результат
рекомендовать: рекомендую
реконструирование: реконструирование
рекурсивный: рекурсивно
релиз: релиз
репозиторий: репозитория
решать: решает
решение: решение, решением
решить: решит, решить, решил
ровно: ровно
родитель: родителя, родителем, родителей
родительский: родительский, родительским, родительские, Родительским, родительскому, родительского
руководствоваться: руководствуйтесь
русский: русский, русском
рухнуть: рухнет
ряд: ряда, ряд
с: С
сайт: сайт
сам: Сам
самостоятельно: самостоятельно
самый: самым, самые, самое, Самый, самый, Самые, самых
сбой: сбои
свежеразобрать: свежеразобранным
сверху: сверху
свой: своими, свой
свойство: свойства
связать: связана
связь: связь, Связь
сгенерировать: сгенерировал
сделать: сделать, сделаете, сделает
селектор: Селекторы, селектора, селектору, селекторов, селекторы, селектор, селекторах
семейный: семейным
серия: серию
сигнатура: Сигнатура
сила: сила
сильно: сильно
сильный: сильная
символ: Символ, символом, символов, символа, символ, символы
синтаксис: синтаксисом
синтаксический: синтаксической
система: системы, системе
ситуация: ситуациях
сказать: скажете
сканировать: сканирует, сканировать
скачать: скачать
скинуть: скинуть
скобка: скобки
сконвертировать: сконвертирован
скопировать: скопировать
скорее: скорее
скорость: скорость
скрипт: скрипт
следовать: следует
следующий: следующих, следующем, следующее, Следующий, следующего, следующий
слияние: слияние
словарь: словарь, словарю, словарем
слово: словом, слов, слово
сложный: сложный, сложное, сложной
служить: служит, служили
случай: случаев, случае, случаях, случай
случайно: случайно
случаться: случается
случиться: случится
смежный: смежных
смениться: сменилось
смешанный: смешанный
смотреть: Смотрите, см, См, смотрим
смысл: смысле, смысла
сначала: Сначала
снеговик: снеговиков, снеговик, Снеговики
снизу: снизу
собирать: собирать
собственный: собственными, собственные
событие: событий
совершенно: совершенно
совместимость: совместимости, совместимость
совместимый: совместимыми, совместимое, совместим, совместимые
совпадение: совпадение, совпадения
содержать: содержат, содержит, содержать, содержащей, содержащий
содержаться: содержится
содержимое: содержимого, содержимым, содержимое
создавать: Создает, создаете
создание: создания
создать: созданный, создать, Создайте, созданной, создадут
сократить: сокращенную
сокращение: сокращения, сокращений
сообщение: сообщения, сообщение, сообщению
сообщить: сообщит
соответственно: соответственно
соответствие: соответствия, соответствии, соответствие
соответствовать: соответствуют, соответствующий, соответствую, соответствует, соответствовать
соответствующий: соответствующие
сортировать: сортирует
сортировка: сортировку
состав: составе
состоять: состоящие
сохранить: сохранить
специальный: специальное, специальные, специальным
спецификация: спецификации
специфичный: специфичный, специфичные, специфичным
список: списка, Список, список, списки, списке
способ: способом, способы, способа, способ, способов
сработать: сработает
сравнение: сравнения
сравнительный: сравнительную
сразу: сразу
среда: средах, среды, среде
среди: Среди
средство: средства, Средства
ссылка: ссылки, ссылку, ссылкой
стандарт: стандарта
стандартный: стандартную
становиться: становится
старт: старт
старый: старый, старых
стать: станут
стоить: стоит
сторонний: сторонних
страна: стране
страница: странице, страницу, страницы
строгий: строгий
строка: строки, строку, строкой, строка, Строка, строк, строке, Строки, строках
строковый: строковыми, строкового, строковое
строчка: строчке
структура: структуру, структуры, структуре
суммировать: суммирует
суп: супа, супе
существовать: Существует
существующий: существующие
счастие: счастью
считать: считая, считает, считать
считаться: считается
сэкономить: сэкономит, сэкономить
таблица: таблица, таблицу
так: Так
таки: таки
такой: таких, Таким, Такое, такому, таким, такого
тарабарщина: тарабарщину
тащить: тащить
тег: тегами, тегах, тегу, тегом, тег, теги, Теги, тега, теге, Тег, тегов
текст: текст, тексте, тексту, текста
текстовый: текстовая, текстовых, текстового, текстовые, текстовом, Текстовые
текущий: текущий, текущим
тем: Тем
теперь: Теперь
терминология: терминологию
технический: Техническая
тип: типа, тип
типичный: типичны, Типичное, типичный
тот: той
точка: точку, точкой, Точка
точнее: точнее
точно: точно
точность: точности
точный: точным, точное, точную
трата: тратой
три: тремя, трех
трюк: трюк
у: У
убедиться: Убедитесь
уверить: уверены
увидеть: увидим
угадывать: угадывает
угловой: угловые
углубиться: углубиться
угодный: угодно
удалить: удалена, удалить, удалены
удалять: удаляет, удалять
удаляться: удаляются
удалённый: удален
удивительно: удивительно
удобно: удобно
удобный: удобны
узел: узле
узнать: узнать
указание: Указание
указанный: указанный
указать: указав, укажете, указать
указывать: указывает, указывают, указывая
уловить: уловить
улучшить: Улучшена
уменьшить: уменьшит
умолчание: умолчанию
уничтожать: уничтожает
уничтожить: уничтожено
упаковать: упакован, упаковать
упомянуть: упомянутыми, упомянутый, упомянуть
управление: управления
уровень: уровня, уровне
ускорить: ускорить
устанавливать: устанавливаете, устанавливая
установить: установите, установив, установить, установлены, установили, установлен, установит
установиться: установиться
установка: установку, установки, установке, Установка
установленный: установленным
устареть: устарели, устарел
устранение: Устранение
фабричный: фабричный
файл: файл, файле, файлов, файла
факт: факт
фактически: фактически
февраль: февраль
фильтр: фильтры, фильтр, фильтру, фильтров, фильтрам
фильтрация: фильтрации
фильтровать: фильтровать
формат: форматах
форматирование: форматированием, форматирование, форматирования
фрагмент: фрагментом, фрагмента, фрагмент, фрагменту, фрагментов, фрагменте
функция: функции, Функция, функций, функцию, функция
хороший: лучшим, хорош, Наилучшим, лучший
хотеть: хочу, хотите
хотя: Хотя
хранение: хранения
целиком: целиком
целое: целое, целом
час: часам
частность: частности
часть: частях, части, частью, часть, частям
часы: часы
чем: Чем
черта: черту
четыре: четырьмя
число: числа, число
числовой: числовые
чистый: чистые, чистый
читать: читайте, читать, Читайте
что: Что
чтобы: Чтобы
чудо: чудес
эквивалентный: эквивалентны
экономить: экономит
экранироваться: экранируются
элемент: элементу, элементом, элементами, элементов, элемента, элементы, элемент
это: Это, Этим
этот: Этот, Эти, Эта
я: Я
являться: являются, является
явно: явно
явный: явное
язык: языки, языке, язык
ярлык: ярлыка
